14
11
PPPPPPXPPPP
PPPPPPXXPPP
PPPPPPXXPPP
PPPPPPXXPPP
PPPPPPPXPPP
PXXXXXXXPPP
PXPPPPXXPPP
PXPPPPPPPPP
PXPPPPPPPPP
PXPPPPPPPPP
PXXPPPPPPPP
PXXXXXXXPPP
PXXXPXXXXPP
PPPPPPPPXPP
